111111111111111111
1E00000C00000M0001
100100000111001001
1010010000C1001001
101111100111001001
1000C1000100001001
100001000111000001
1P0N000C00000010C1
111111111111111111